NO texture_files/a1.xpm
SO texture_files/a2.xpm
WE texture_files/a3.xpm
EA texture_files/a4.xpm
F 30,39,46
C 44,44,84

11111111111111111111111111111
10110000011100000000000010001
10010000000000000000000010001
10110000011000000000000010001
10000000001D100000111011110001
11110111111111011100000010001
11110111111111011101010010001
110000001110101011100000010001
10000000000000001100000010001
10000000000000010101010010001
110000101101D1000000000000001
11111D100110001000000101000001
10000010011000001000000100111
11010000101000001000100001001
1001D1000000000010000000001001
10000000001101000000000000001
10000000001101000000000000001
10000000001101000000000000001
10000000001101000000000000001
1000N000000100000001010000001
11111111111111111111111111111
