NO texture_files/a1.xpm
SO texture_files/a2.xpm
WE texture_files/a3.xpm
EA texture_files/a4.xpm
F 30,39,46
C 44,44,84

11111111111111111111111111111
10110000011100000000000010001
10010000000000000000000010001
10110000011000000000000010001
10000000001D100000111011110001
1111D111100111000000000010001
1111011110011000001010010001
11010100101010000000000010001
1000000000000000000000010001
1000000000000000001010010001
110000101101D100000000000001
11111010011000010100101000001
1000001001100000000000100111
1101000010100000000100001001
10010100000000000000000001001
1000000000110000000000000001
100000000011001D100000000001
1001D10000110000000000000001
1000000000110000000000000001
100000000010000N001010000001
11111111111111111111111111111
