NO texture_files/a1.xpm
SO texture_files/a2.xpm
WE texture_files/a3.xpm
EA texture_files/a4.xpm
F 30,39,46
C 44,44,84

11111111111111111111111111111
10110000011100000000000010001
10010000000000000000000010001
10110000011100000000000010001
10000000001100000111011110001
11110111111111011100000010001
11110111111111011101010010001
11000000110101011100000010001
10000000000000001100000010001
1000000000000001D101010010001
1100001D110101000000000000001
11111100110101000000101000001
10000110011000001000000100111
11010000101000001000100001001
100000N000D000010000000001001
10000000001101000000000000001
10000000000100000001010000001
11111111111111111111111111111
