NO texture_files/2.xpm
SO texture_files/2.xpm
WE texture_files/2.xpm
EA texture_files/2.xpm
F 30,39,46
C 30,81,123

111111111111111111111111
101100000111000000100001
100100000001000001000001
101100N0011 1000000000001
111111111111111111111111