NO texture_files/t1.xpm
SO texture_files/t2.xpm
WE texture_files/t3.xpm
EA texture_files/t4.xpm
DO texture_files/door.xpm
F 116,125,140
C 30,144,255

11111111111111111111111111111
10110000011100000000000010001
10010000000000000000000010001
10110000011100000000000010001
10000000001100000111011110001
11110111111111011100000010001
11110111111111011101010010001
11000000110101011100000010001
10000000000000001100000010001
10000000000000001101010010001
11000000110101000000000000001
11110110110101000000101000001
10000000001100000100000010011
10000000000000001000100001001
100000000N1000010000000001001
10000000001101000000000000001
10000000000100000001010000001
11111111111111111111111111111