EA libft/libft.a
NO libft/libft.a
SO test h
WE libft/libft.a
F 184,113,39
C 51,198,80

11111111111111111111111111111
10110000011100000000000010001
10010000000000000000010010001
10110000011100000000101000101
10000000001100000111011110110
11110111111111011100000010001
11110111111111011101010010001
11000000110101011100000010001
10000000000000001100000010001
10000000000000001101010010001
11000000110101000000000000001
11110111110101000000101000001
10000000001100000100000010001
10000000000000001000100001001
10000000001000010000000001001
10000000001101000000N00000001
10000000000100000001010000001
11111111111111111111111111111

11111111111111111111111111111
10110000011100001N00000010001111
1001000000000001 1000100100000111
11111111111111111111111111111
                1