NO texture_files/a1.xpm
SO texture_files/a2.xpm
WE texture_files/a3.xpm
EA texture_files/a4.xpm
F 30,39,46
C 44,44,84

11111111111111111111111111111
10110000011100000000000010001
10010000000000000000000010001
10110000011100000000000010001
10000000001D100000111011110001
11110111111111011100000010001
111101111D11111011101010010001
11000000110101011100000010001
10000000000000001100000010001
10000000000000010101010010001
11000010110101000000000000001
111D11100110101000000101000001
10000110011000001000000100111
11010000101000001000100001001
100000N0000000010000000001001
10000000001101000000000000001
10000000000100000001010000001
11111111111111111111111111111
