NO textures/sky_1.xpm
SO textures/sky_1.xpm
WE textures/sky_1.xpm
EA textures/sky_1.xpm
S textures/sprite_1.xpm
SU textures/sprite_2.xpm
SC textures/sprite_3.xpm
R 848 480
F 184,113,39
C 51,198,227
11111111111111111111111111
111000001111111111110111111
111000001111111111110111111
111000001111110000001101111
111000001111110000001101111
11100000111111000000N111111
111111111111111111111111111