NO ./texture_files/2.xpm
SO ./texture_files/2.xpm
WE ./texture_files/2.xpm
EA ./texture_files/2.xpm

F 184,113,39
C 51,198,227
111111111111111111111111111111111111111
1111111111         11111111111111000000000000000000000000000011
100000000111111111110000000000000000000000000000000000000000001
100000000000000000010000000000000100000000000000000000000000001
10000000011111111111000000000000010000000000000000000000000001
100111111        1111100000000000000000000000000000000000000001
101          11111000000000000000000000000000000000000000000001
10011111          1111100000000000000000000000000000000000000001
100000001          11111000000000000000000000000000000000000001
100000001          1110000000000000000000000000000000000000001111111
100000001          1110000000000000000001000000001000000000001111
100000001          1111111000000000000001000000N01000000000000000111
1000000011111          111111000000000001000000001000000000000000000111111
1000000000011          111100000000000001000000001000000000000000011111
10000000001          1111110000000000000000000000000000000000000001111
1000000011          111110000000000000000000000000000000000000001111111
100000001          11110000000000000000000000000000000000000001111111
100000001111111        11111000000000000000000000000000000000000000111111
1000000000000001111111    111100000000000000000000000000000000000000011
11111111100000000111111     111111111111111111110111111111111111111111
10000000000000001                             11011
10000000000000001                             11011
10000000000000001          1111111111111111111110111111111111111111111111111
10000000000000001111111111100000000000000000000000000000000000000000000001111
100000000000000000000000000000000000000000000000000000000000000000000000000011
10000000000000001111111111110000000000000000000000000000000000000000000000111
10000000000000001           11110000000000000000000000011111111111111111111111
111111111111111111111111111111111111111111111111111