NO get_next_line/get_next_line.c
SO libft/libft.a
WE libft/ft_isdigit.c
C 225,255,0
F 220,100,0
EA libft/ft_strchr.c
        11111111111111111111111111
        1000011000111100110000001
        1011000001110100010010001111111
        1001000000000000000111000111101
1111111110110000011100000000100011111
100000000011000001110111111111111
11110111111111011100000010001
11110111111111011101010010001
11000000110101011100000010001
10000000000000001100000010001
1000000000N000001101010010001
110000011101010111110111100111
111101111110101101111010001
11111111111111111111111111111