NO get_next_line/get_next_line.c
SO libft/libft.a
WE libft/ft_isdigit.c
C 225,255,0
F 220,100,0
EA libft/ft_strchr.c
1111111111111111111111111111111111111
10N0110000100000000000001000011100011
1000110000000000111111001000111111101
1000110000000000110001001111111101011
1000000000100000000001001000000111111
1110001110000000000011111001101100111
1111110000011100011110011111111001111
1111111111111111111111111111111111111