NO get_next_line/get_next_line.c
SO libft/libft.a
WE libft/ft_isdigit.c
EA libft/ft_strchr.c
C 28,147,156
F 193,154,107
111111111111111111111
100S00000000000000001
100100100100100100101
100000000000000000001
100000000010000000001
111111111111111111111