111111111111111111111111111111111
        1010000000110000110000001
        1011000001110000010010001
        10010000000000000001110001
111111111011000001110000000010001
100000000011000001110111111111111
11110111111111011100000010001
11110111111111011101010010001
11000000110101011100000010001
10000000000020001100000010001
10000000000000001101010000000
11000001110101011111011110N0111
11110111111010110111101000100001
111111111111111111111111111111111