NO get_next_line/get_next_line.c
SO libft/libft.a
WE libft/ft_isdigit.c
EA libft/ft_strchr.c
C 225,255,0
F 220,100,0
1111111111111111111111111
1E00000000000000011100001
1111000001110000000001111
1111000000001110000000001
1000000011111100000011111
1111000101011111111000001
1111111111111111111111111