NO ./textures/metal_ 1.xpm
SO ./textures/metal_2.xpm
WE ./textures/metal_3.xpm
EA ./textures/metal_4.xpm
F 30, 39 , 46
C 34, 112, 147

11111111111111111    111
111000000000011111   111101
11100001010001111 111111
111010000N0001111   111111111111
111000100000111111110111
111111111111111111111111
11111111111111111    111
111000000000011111   111101
11100001010001111 111111
11101000000001111   111111111111
111000100000111111110111
111111111111111111111111
