NO ./textures/metal_1.xpm
SO ./textures/metal_2.xpm
WE ./textures/metal_3.xpm
EA ./textures/metal_4.xpm
C 34, 112, 147
F 30, 39, 46

11111111111111111    111
111000000000011111111101
11100001010001111 111111
111010000N0001111   1111     11111111
111000100000111111110111
111111111111111111111111