NO ./textures/metal_1.xpm
SO ./textures/metal_2.xpm
EA ./textures/metal_4.xpm
WE ./textures/metal_3.xpm
C 34,55,147
F 30,012,4

111111111
111101111
1N1010001
111111111