NO ./textures/metal_1.xpm
SO ./textures/metal_2.xpm
WE ./textures/metal_3.xpm
EA ./textures/metal_4.xpm
C 34, 112, 147
F 30, 39, 46

111111111111
1110110000011
111111D1D1D11001  
111001N10101
111111111111