NO ./textures/metal_1.xpm
SO ./textures/metal_2.xpm
WE ./textures/metal_3.xpm
EA ./textures/metal_4.xpm
C 34, 112, 147
F 30, 39, 46

111111111111111111  111
111000000000011110111101
111000000000011110111101
111000000000011110111101
111000000000011110111101
111000000000011110111101
111000000000011110111101
111000000000011110111101
111000000000011110111101
111000000000011110111101
111000000000011110111101
111000000000011110111101
111000000000011110111101
111000000000011110111101
111000000000011110111101
111000000000011110111101
111000000000011110111101
111000000000011110111101
111000000000011110111101
111000000000011110111101
111000000000011110111101
111000000000011110111101
111000001D10011110111101
11100000000100011111111111
111010000N0001111111111111111
111000100000111111110111
111111111111111111111111